#######
#  V  #
#     #
#.....#
#.....#
#.....#
#.....#
#     #
#...  #
#  ...#
#.....#
#     #
#.....#
#.....#
#.....#
#.....#
#.....#
#.....#
#.###.#
#..M..#
#######